CMCC_LIGHT_CUST_SUPPORT	no
MTK_C2K_LTE_MODE	1
MTK_CMAS_SUPPORT	no
MTK_CMCC_FT_PRECHECK_SUPPORT	no
MTK_CT4GREG_APP	no
MTK_CTA_SET	yes
MTK_DEVREG_APP	no
MTK_DISABLE_CAPABILITY_SWITCH	no
MTK_DYNAMIC_SBP_SUPPORT	yes
MTK_ENABLE_MD3	yes
MTK_EPDG_SUPPORT	yes
MTK_FLIGHT_MODE_POWER_OFF_MD	yes
MTK_IMS_SUPPORT	yes
MTK_INPUTMETHOD_COOTEKIME_TOUCHPAL	yes
MTK_IRAT_SUPPORT	yes
MTK_MD1_SUPPORT	5
MTK_MD3_SUPPORT	2
MTK_MD_SBP_CUSTOM_VALUE	0
MTK_MOBILE_MANAGEMENT	yes
MTK_MODEM_MONITOR_SUPPORT	yes
MTK_MULTI_SIM_SUPPORT	dsda
MTK_NETWORK_TYPE_ALWAYS_ON	no
MTK_PERMISSION_CONTROL	yes
MTK_PRIVACY_PROTECTION_LOCK	yes
MTK_PROTOCOL1_RAT_CONFIG	C/Lf/Lt/W/T/G
MTK_PROTOCOL2_RAT_CONFIG	G
MTK_REGIONALPHONE_SUPPORT	no
MTK_RILD_READ_IMSI	yes
MTK_RTSP_BITRATE_ADAPTATION_SUPPORT	no
MTK_SYSTEM_UPDATE_SUPPORT	yes
MTK_TDD_DATA_ONLY_SUPPORT	yes
MTK_TTY_SUPPORT	yes
MTK_VILTE_SUPPORT	yes
MTK_VOLTE_SUPPORT	yes
MTK_VT3G324M_SUPPORT	no
OPTR_SPEC_SEG_DEF	NONE
MTK_WFC_SUPPORT	yes
MTK_TER_SERVICE	no
MTK_CC33_SUPPORT	no
MTK_DTAG_DUAL_APN_SUPPORT	no

